-- MAPPE --


1
###################
o    #          $ #
#    #          $ #
#    #   !  #   $ #
#    #      #   $ #
#    #      #     _
#    #      #     #
#           #     #
#    $$$$   #     #
###################
end

2
######
#    #
# !! #
o $$ #
#    _
######
end

3
########o#
#   $$   #
#  ####  #
#T #  #  #
#  ####  #
#    !   #
#_########
end
